1111111111111111111111111111111111111111111111111111
1P00000000000000000000000000000000000000000000000001
1011111111111011111111111011111111111011111111110101
1010000000000010000000000010000000000010000000000101
1010000000000010000000000010000000000010000000000101
1010000000000010000000000010000000000010000000000101
1010000000000010000000000010000000000010000000000101
1010000000000010000000000010000000000010000000000101
1010111111111110111111111110111111111110111111111101
1000000000000000000000000000000000000000000000000001
1011111111111011111111111011111111111011111111110101
1010000000000010000000000010000000000010000000000101
1010000000000010000000000010000000000010000000000101
1010000000000010000000000010000000000010000000000101
1010000000000010000000000010000000000010000000000101
1010111111111110111111111110111111111110111111111101
1000000000000000000000000000000000000000000000000001
1111111111111111111111111111111111111111111111111111
