12111111111111111111111111111111111
10000000000000000000000000000000001
10111111111111111111111111111111101
10000000000000000000000000000000001
1P001111111111111001111111111111102
10001111111111112001111111111111101
10000000000000000000000000000000001
10111111111111111111111111111111101
10000000000000000000000000000000001
12111111111111111111111111111111111
