11111111111111111111111111111111111
1P000000000000000000000000000000001
10111111111111111111111111111111101
10000000000000000000000000000000001
10001111111111111001111111111111101
10001111111111111001111111111111101
10000000000000000000000000000000001
10111111111111111111111111111111101
10000000000000000000000000000000001
11111111111111111111111111111111111
