1111111111111111111111111111111111111111
1P20000001111000000011110000000000000001
1011111101111011111011110111111111100001
1000000100001010000010000100000000100001
1111100111101010111110111101111100101101
1000100000101000100000000100000100100001
1010101110101110101111100111100100111101
1010101000100000100000100000100100000001
1011101011111110111110111110100111111001
1000001000000010000000000010100000001001
1011111011111010111111111010111111101001
1000000010001010000000010010000000101001
1111111010111010111111011110111110101001
1000000010100010100000010000100000101001
1011111010111110101111010111101111101001
1010000010000010100000010000100000100001
1010111111111010111111111111101110101111
1010100000000010000000000000001010100001
1010111111111110111111111110101010111101
1000100000000010000000000000100010000001
1111101111101111111011111111101111111101
1000001000100000001010000000001000000001
1011111010111111101010111111101111111101
1000000010100000100010100000100000000001
1111111010101110111110111010111110111101
1000000010001010000000001010000010120001
1000001111111010111111111010111110111011
1111111111111111111111111111111111111111
