1112111111111
1000P01111111
1011101111111
1011101111111
1010101111111
1000001111111
1110111111111
1110111111111
1110111111111
1110111111111
1110000000021
1110111111011
1110111111011
1110111111011
1120111111011
1110111111011
1110000000011
1110000000011
1110001000011
1110001000011
1110000000021
1111000000111
1111100001111
1111110011111
1111112111111 